
F 32, 32, 32
C 0, 0, 102


NO textures/simonkraft/wet_sponge.xpm
SO textures/simonkraft/wet_sponge.xpm
WE textures/simonkraft/wet_sponge.xpm
EA textures/simonkraft/wet_sponge.xpm


111111111111111111111
1W00000000000000000011 
11111111111111111E111
