NO textures/stone.xpm
SO textures/grey.xpm
WE textures/mossy.xpm
EA textures/red.xpm

F 164,169,20
C 153,204,255

111111111111111111111
101000001000000000001
101010101011111110001
100010100010000010001
111110101111101011101
100000101000101000001
101111101011101111111
101000001010100000101
101011111010111110101
101010001010100010101
101110101010101010101
100000101010001010001
111311101011111011101
130000101000300010001
101110101110101110111
100000100000100010101
111111113011111010101
130020000000000310001
100010111011111111101
1E0000031000000000001
111111111111111111111

