F 76,76,76
C 99,99,99

NO textures/ocean.xpm
SO textures/purple.xpm
WE textures/tile.xpm
EA textures/saphire.xpm

1111111111111111111
10W1001001001000001
1013000002000001001
1001001001111101211
1001111000001001001
1000000000000003001
1001111211111001001
1131000000000001011
1000000001000000001
1111111111111111111

