NO textures/brick.xpm
SO textures/grey.xpm
WE textures/mossy.xpm
EA textures/red.xpm

F 220,100,0
C 225,30,0

        1111111111111111111111111
        1000000000110000000000001
        1011000001110300000030001
        1001000000000000000000001
111111111011000001110000000000001
100000000011000001110111112111111
11110111111111011100000003001
11110111111111011101010000001
11000000110101011100300010001
10000000000000001300000020001
10000000000000001101010010001
11000001110101011111013000N0111
11110111 1110101 101111010301
11111111 1111111 111111111111
