   WE                            textures/ceiling.xpm
NO      textures/stone.xpm



SO textures/tile.xpm

F      17,    38,     64

EA textures/yellow.xpm



C 218, 234, 235

1111111111111111111111111
10S0110000100000000000001
1000110000100000111111001
1000110000200000110001001
1030000000100000000002001
1111111111111111111111111
