   WE                            textures/ceiling.xpm
NO      textures/stone.xpm



SO textures/tile.xpm

F      17,    38,     64

EA textures/yellow.xpm



C 218, 234, 235

1111111111111111111111111
10S0110003100000000000001
1000110000100003111111001
1000110000200000110031001
1000000000100000000002001
1111111111111111111111111
