
F 32, 32, 32
C 0, 0, 10
NO textures/blue.xpm
SO textures/grey.xpm
WE textures/mossy.xpm
EA textures/red.xpm

111111111111111111111
100000000000000000011
111111111111110111111


