
F 32, 32, 32
C 0, 0, 102


NO textures/blue.xpm
SO textures/grey.xpm
WE textures/mossy.xpm
EA textures/red.xpm


111111111111111111111
1W000000000000E0000011 
111111111111111111111
