NO ./textures/north.xpm
SO ./textures/south.xpm
WE ./textures/west.xpm
EA ./textures/east.xpm

F 100,150,200
C 200,150,100

1111111
1000001
1011101
1000N01
1111111
